S....#..
.#.###I.
.#...P..
.P......
.#.#A#..
.#PI###.
.#A#.##.
I#G..PI.