S#G..A.P.#
.######.#.
..P##...#I
...#.#..#P
...#...#..
.#P...##..
..I##.PI..
#A#IP.#A..
#.#.....#.
#I#...I.#.